476
AIR CONDITIONER:WINDOW:CYCLING	ZoneHVAC:WindowAirConditioner
AIR DISTRIBUTION UNIT	ZoneHVAC:AirDistributionUnit
AIR LOOP EQUIPMENT LIST	AirLoopHVAC:OutdoorAirSystem:EquipmentList
AIR PRIMARY LOOP	AirLoopHVAC
AIRFLOWNETWORK SIMULATION	AirflowNetwork:SimulationControl
AIRFLOWNETWORK:DISTRIBUTION:COMPONENT COIL	AirflowNetwork:Distribution:Component:Coil
AIRFLOWNETWORK:DISTRIBUTION:COMPONENT CONSTANT PRESSURE DROP	AirflowNetwork:Distribution:Component:ConstantPressureDrop
AIRFLOWNETWORK:DISTRIBUTION:COMPONENT CONSTANT VOLUME FAN	AirflowNetwork:Distribution:Component:ConstantVolumeFan
AIRFLOWNETWORK:DISTRIBUTION:COMPONENT DUCT	AirflowNetwork:Distribution:Component:Duct
AIRFLOWNETWORK:DISTRIBUTION:COMPONENT LEAK	AirflowNetwork:Distribution:Component:Leak
AIRFLOWNETWORK:DISTRIBUTION:COMPONENT LEAKAGE RATIO	AirflowNetwork:Distribution:Component:LeakageRatio
AIRFLOWNETWORK:DISTRIBUTION:COMPONENT TERMINAL UNIT	AirflowNetwork:Distribution:Component:TerminalUnit
AIRFLOWNETWORK:DISTRIBUTION:LINKAGE	AirflowNetwork:Distribution:Linkage
AIRFLOWNETWORK:DISTRIBUTION:NODE	AirflowNetwork:Distribution:Node
AIRFLOWNETWORK:MULTIZONE:COMPONENT DETAILED OPENING	AirflowNetwork:MultiZone:Component:DetailedOpening
AIRFLOWNETWORK:MULTIZONE:COMPONENT SIMPLE OPENING	AirflowNetwork:MultiZone:Component:SimpleOpening
AIRFLOWNETWORK:MULTIZONE:COMPONENT ZONE EXHAUST FAN	AirflowNetwork:MultiZone:Component:ZoneExhaustFan
AIRFLOWNETWORK:MULTIZONE:EXTERNAL NODE	AirflowNetwork:MultiZone:ExternalNode
AIRFLOWNETWORK:MULTIZONE:REFERENCE CRACK CONDITIONS	AirflowNetwork:MultiZone:ReferenceCrackConditions
AIRFLOWNETWORK:MULTIZONE:SITE WIND CONDITIONS	AirflowNetwork:MultiZone:SiteWindConditions
AIRFLOWNETWORK:MULTIZONE:SURFACE	AirflowNetwork:MultiZone:Surface
AIRFLOWNETWORK:MULTIZONE:SURFACE CRACK DATA	AirflowNetwork:MultiZone:Surface:Crack
AIRFLOWNETWORK:MULTIZONE:SURFACE EFFECTIVE LEAKAGE AREA	AirflowNetwork:MultiZone:Surface:EffectiveLeakageArea
AIRFLOWNETWORK:MULTIZONE:WIND PRESSURE COEFFICIENT ARRAY	AirflowNetwork:MultiZone:WindPressureCoefficientArray
AIRFLOWNETWORK:MULTIZONE:WIND PRESSURE COEFFICIENT VALUES	AirflowNetwork:MultiZone:WindPressureCoefficientValues
AIRFLOWNETWORK:MULTIZONE:ZONE	AirflowNetwork:MultiZone:Zone
AngleFactorList	ComfortViewFactorAngles
BASEBOARD HEAT	ZoneBaseboard:OutdoorTemperatureControlled
BASEBOARD HEATER:ELECTRIC:Convective	ZoneHVAC:Baseboard:Convective:Electric
BASEBOARD HEATER:WATER	ZoneHVAC:Baseboard:RadiantConvective:Water
BASEBOARD HEATER:Water:Convective	ZoneHVAC:Baseboard:Convective:Water
BOILER:SIMPLE	Boiler:HotWater
BOILER:SPARK:SBOILER	Boiler:HotWater:SPARK
BOILER:STEAM	Boiler:Steam
BRANCH	Branch
BRANCH LIST	BranchList
BUILDING	Building
CASE:REFRIGERATED	Refrigeration:Case
CHILLER:ABSORPTION	Chiller:Absorption
CHILLER:COMBUSTION TURBINE	Chiller:CombustionTurbine
CHILLER:CONST COP	Chiller:ConstantCOP
CHILLER:DIRECT FIRED ABSORPTION	ChillerHeater:Absorption:DirectFired
CHILLER:ELECTRIC	Chiller:Electric
CHILLER:ELECTRIC:EIR	Chiller:Electric:EIR
CHILLER:ELECTRIC:REFORMULATEDEIR	Chiller:Electric:ReformulatedEIR
CHILLER:ENGINEDRIVEN	Chiller:EngineDriven
CHILLER:INDIRECTABSORPTION	Chiller:Absorption:Indirect
CHILLER:SPARK:ECHILLER	Chiller:Electric:SPARK
COIL:Desuperheater:Heating	Coil:Heating:Desuperheater
COIL:DX:CoolingBypassFactorEmpirical	Coil:Cooling:DX:SingleSpeed
COIL:DX:CoolingHeatExchangerAssisted	CoilSystem:Cooling:DX:HeatExchangerAssisted
COIL:DX:HeatingEmpirical	Coil:Heating:DX:SingleSpeed
COIL:DX:HEATPUMPWATERHEATER	Coil:WaterHeating:AirToWaterHeatPump
COIL:DX:MultiMode:CoolingEmpirical	Coil:Cooling:DX:TwoStageWithHumidityControlMode
Coil:DX:MultiSpeed:Cooling	Coil:Cooling:DX:MultiSpeed
COIL:DX:MultiSpeed:CoolingEmpirical	Coil:Cooling:DX:TwoSpeed
COIL:DX:MULTISPEED:HEATING	Coil:Heating:DX:MultiSpeed
COIL:Electric:Heating	Coil:Heating:Electric
COIL:Gas:Heating	Coil:Heating:Gas
COIL:Steam:AirHeating	Coil:Heating:Steam
COIL:Water:Cooling	Coil:Cooling:Water
COIL:Water:CoolingHeatExchangerAssisted	CoilSystem:Cooling:Water:HeatExchangerAssisted
COIL:Water:DesuperheaterHeating	Coil:WaterHeating:Desuperheater
COIL:Water:DetailedFlatCooling	Coil:Cooling:Water:DetailedGeometry
COIL:Water:SimpleHeating	Coil:Heating:Water
COIL:WaterToAirHP:EquationFit:Cooling	Coil:Cooling:WaterToAirHeatPump:EquationFit
COIL:WaterToAirHP:EquationFit:Heating	Coil:Heating:WaterToAirHeatPump:EquationFit
COIL:WaterToAirHP:ParameterEstimation:Cooling	Coil:Cooling:WaterToAirHeatPump:ParameterEstimation
COIL:WaterToAirHP:ParameterEstimation:Heating	Coil:Heating:WaterToAirHeatPump:ParameterEstimation
CoilPerformance:DX:CoolingBypassFactorEmpirical	CoilPerformance:DX:Cooling
COMPACT HVAC:PLANT:BOILER	HVACTemplate:Plant:Boiler
COMPACT HVAC:PLANT:CHILLED WATER LOOP	HVACTemplate:Plant:ChilledWaterLoop
COMPACT HVAC:PLANT:CHILLER	HVACTemplate:Plant:Chiller
COMPACT HVAC:PLANT:HOT WATER LOOP	HVACTemplate:Plant:HotWaterLoop
COMPACT HVAC:PLANT:TOWER	HVACTemplate:Plant:Tower
COMPACT HVAC:SYSTEM:UNITARY	HVACTemplate:System:Unitary
COMPACT HVAC:SYSTEM:VAV	HVACTemplate:System:VAV
COMPACT HVAC:THERMOSTAT	HVACTemplate:Thermostat
COMPACT HVAC:ZONE:FAN COIL	HVACTemplate:Zone:FanCoil
COMPACT HVAC:ZONE:PTAC	HVACTemplate:Zone:PTAC
COMPACT HVAC:ZONE:PTHP	HVACTemplate:Zone:PTHP
COMPACT HVAC:ZONE:PURCHASED AIR	HVACTemplate:Zone:IdealLoadsAirSystem
COMPACT HVAC:ZONE:UNITARY	HVACTemplate:Zone:Unitary
COMPACT HVAC:ZONE:VAV	HVACTemplate:Zone:VAV
COMPACT HVAC:ZONE:VAV:FAN POWERED	HVACTemplate:Zone:VAV:FanPowered
COMPONENT SETPOINT BASED OPERATION	PlantEquipmentOperation:ComponentSetpoint
COMPRESSOR RACK:REFRIGERATED CASE	Refrigeration:CompressorRack
CONDENSER EQUIPMENT LIST	CondenserEquipmentList
CONDENSER LOOP	CondenserLoop
CONDENSER OPERATION SCHEMES	CondenserEquipmentOperationSchemes
CONNECTION COMPONENT:PLANTLOOP	PlantLoopConnection
CONNECTION COMPONENT:PLANTLOOP:CONTROLLED	PlantLoopConnection:Controlled
CONNECTOR LIST	ConnectorList
CONSTRUCTION	Construction
CONSTRUCTION FROM WINDOW5 DATA FILE	Construction:WindowDataFile
CONSTRUCTION WITH INTERNAL SOURCE	Construction:InternalSource
CONTROLLED ZONE EQUIP CONFIGURATION	ZoneHVAC:EquipmentConnections
CONTROLLER LIST	AirLoopHVAC:ControllerList
CONTROLLER:OUTSIDE AIR	Controller:OutdoorAir
CONTROLLER:SIMPLE	Controller:WaterCoil
CONTROLLER:STAND ALONE ERV	ZoneHVAC:EnergyRecoveryVentilator:Controller
ConvectionCoefficients	SurfaceProperty:ConvectionCoefficients
ConvectionCoefficients:MultipleSurface	SurfaceProperty:ConvectionCoefficients:MultipleSurface
COOLING LOAD RANGE BASED OPERATION	PlantEquipmentOperation:CoolingLoad
COOLING TOWER:SINGLE SPEED	CoolingTower:SingleSpeed
COOLING TOWER:TWO SPEED	CoolingTower:TwoSpeed
COOLING TOWER:VARIABLE SPEED	CoolingTower:VariableSpeed
COOLING TOWER:VARIABLE SPEED:COOLTOOLS MODEL COEFFICIENTS	CoolingTowerPerformance:CoolTools
COOLING TOWER:VARIABLE SPEED:YORKCALC MODEL COEFFICIENTS	CoolingTowerPerformance:YorkCalc
COOLTOWER:SHOWER	ZoneCoolTower:Shower
CROSS MIXING	ZoneCrossMixing
CURVE:BICUBIC	Curve:Bicubic
CURVE:BIQUADRATIC	Curve:Biquadratic
CURVE:CUBIC	Curve:Cubic
CURVE:LINEAR	Curve:Linear
CURVE:QUADRATIC	Curve:Quadratic
CURVE:QUADRATICLINEAR	Curve:QuadraticLinear
CURVE:TRIQUADRATIC	Curve:Triquadratic
CUSTOM METER	Meter:Custom
CUSTOM METER:DECREMENT	Meter:CustomDecrement 
Daylighting Device:Shelf	DaylightingDevice:Shelf
Daylighting Device:Tubular	DaylightingDevice:Tubular
DAYLIGHTING:DElight	Daylighting:DELight:Controls
DAYLIGHTING:DElight:Complex Fenestration	Daylighting:DELight:ComplexFenestration
DAYLIGHTING:DElight:Reference Point	Daylighting:DELight:ReferencePoint
DAYLIGHTING:DETAILED	Daylighting:Controls
Daylighting:Illuminance Map	Output:IlluminanceMap
Daylighting:Illuminance Map:Style	OutputControl:IlluminanceMap:Style
DaylightSavingPeriod	RunPeriodControl:DaylightSavingTime
DAYSCHEDULE	Schedule:Day:Hourly
DAYSCHEDULE:INTERVAL	Schedule:Day:Interval
DAYSCHEDULE:LIST	Schedule:Day:List
DEBUG OUTPUT	Output:DebuggingData
DEMAND MANAGER LIST	DemandManagerAssignmentList
DEMAND MANAGER:ELECTRIC EQUIPMENT	DemandManager:ElectricEquipment
DEMAND MANAGER:EXTERIOR LIGHTS	DemandManager:ExteriorLights
DEMAND MANAGER:LIGHTS	DemandManager:Lights
DEMAND MANAGER:THERMOSTATS	DemandManager:Thermostats
DESICCANT DEHUMIDIFIER	Dehumidifier:Desiccant:System
DESICCANT DEHUMIDIFIER:SOLID	Dehumidifier:Desiccant:NoFans
DesignDay	SizingPeriod:DesignDay
DIAGNOSTICS	Output:Diagnostics
DIRECT AIR	AirTerminal:SingleDuct:Uncontrolled
DUAL DUCT:CONST VOLUME	AirTerminal:DualDuct:ConstantVolume
DUAL DUCT:VAV	AirTerminal:DualDuct:VAV
DUAL SETPOINT WITH DEADBAND	ThermostatSetpoint:DualSetpoint
DUAL THERMAL COMFORT SETPOINT WITH DEADBAND:FANGER	ThermostatSetpoint:ThermalComfort:Fanger:DualSetpoint
DUCT	Duct
DXSystem:AirLoop	AirLoopHVAC:UnitaryCoolOnly
EARTHTUBE	ZoneEarthtube
Economics:Charge:Block	UtilityCost:Charge:Block
Economics:Charge:Simple	UtilityCost:Charge:Simple
Economics:Component Cost:Adjustments	ComponentCost:Adjustments
Economics:Component Cost:Line Item	ComponentCost:LineItem
Economics:Component Cost:Reference	ComponentCost:Reference
Economics:Computation	UtilityCost:Computation
Economics:CurrencyType	CurrencyType
Economics:Qualify	UtilityCost:Qualify
Economics:Ratchet	UtilityCost:Ratchet
Economics:Tariff	UtilityCost:Tariff
Economics:Variable	UtilityCost:Variable
ELECTRIC EQUIPMENT	ElectricEquipment
ELECTRIC LOAD CENTER:DISTRIBUTION	ElectricLoadCenter:Distribution
ELECTRIC LOAD CENTER:GENERATORS	ElectricLoadCenter:Generators
ElectricLoadCenter:Inverter:FunctionOfPower	ElectricLoadCenter:Inverter:FunctionOfPower
ElectricLoadCenter:Inverter:LookUpTable	ElectricLoadCenter:Inverter:LookUpTable
ElectricLoadCenter:Inverter:Simple	ElectricLoadCenter:Inverter:Simple
ElectricLoadCenter:Storage:Simple	ElectricLoadCenter:Storage:Simple
ENERGY RECOVERY VENTILATOR:STAND ALONE	ZoneHVAC:EnergyRecoveryVentilator
Environmental Impact Factors	EnvironmentalImpactFactors
EvapCooler:Direct:CelDekPad	EvaporativeCooler:Direct:CelDekPad
EvapCooler:InDirect:CelDekPad	EvaporativeCooler:Indirect:CelDekPad
EvapCooler:InDirect:RDDSpecial	EvaporativeCooler:Indirect:ResearchSpecial
EvapCooler:InDirect:WetCoil	EvaporativeCooler:Indirect:WetCoil
ExteriorFuelEquipment	Exterior:FuelEquipment
ExteriorLights	Exterior:Lights
ExteriorWaterEquipment	Exterior:WaterEquipment
FAN COIL UNIT:4 PIPE	ZoneHVAC:FourPipeFanCoil
FAN:NIGHT VENT PERFORMANCE	FanPerformance:NightVentilation
FAN:SIMPLE:ConstVolume	Fan:ConstantVolume
FAN:SIMPLE:ONOFF	Fan:OnOff
FAN:SIMPLE:VariableVolume	Fan:VariableVolume
FLUID COOLER:SINGLE SPEED	FluidCooler:SingleSpeed
FLUID COOLER:TWO SPEED	FluidCooler:TwoSpeed
FluidNames	FluidProperties:Names
FluidPropertyConcentration	FluidProperties:Concentration
FluidPropertySaturated	FluidProperties:Saturated
FluidPropertySuperheated	FluidProperties:Superheated
FluidPropertyTemperatures	FluidProperties:Temperatures
Fuel Factors	FuelFactors
FURNACE:HEATCOOL	AirLoopHVAC:Unitary:Furnace:HeatCool
FURNACE:HEATONLY	AirLoopHVAC:Unitary:Furnace:HeatOnly
GAS EQUIPMENT	GasEquipment
GENERATOR:COMBUSTION TURBINE	Generator:CombustionTurbine
GENERATOR:FUEL CELL	Generator:FuelCell
GENERATOR:FUEL CELL:AIR SUPPLY	Generator:FuelCell:AirSupply
GENERATOR:FUEL CELL:AUXILIARY HEATER	Generator:FuelCell:AuxiliaryHeater
GENERATOR:FUEL CELL:ELECTRICAL STORAGE	Generator:FuelCell:ElectricalStorage
GENERATOR:FUEL CELL:EXHAUST GAS TO WATER HEAT EXCHANGER	Generator:FuelCell:ExhaustGasToWaterHeatExchanger
GENERATOR:FUEL CELL:INVERTER	Generator:FuelCell:Inverter
GENERATOR:FUEL CELL:POWER MODULE	Generator:FuelCell:PowerModule
GENERATOR:FUEL CELL:STACK COOLER	Generator:FuelCell:StackCooler
GENERATOR:FUEL CELL:WATER SUPPLY	Generator:FuelCell:WaterSupply
GENERATOR:FUEL SUPPLY	Generator:FuelSupply
GENERATOR:IC ENGINE	Generator:InternalCombustionEngine
GENERATOR:MICRO CHP	Generator:MicroCHP
GENERATOR:MICRO CHP:NON NORMALIZED PARAMETERS	Generator:MicroCHP:NonNormalizedParameters
GENERATOR:MICROTURBINE	Generator:MicroTurbine
GENERATOR:PV:EQUIVALENT ONE-DIODE	Generator:Photovoltaic
GENERATOR:PV:SANDIA	Generator:Photovoltaic
GENERATOR:PV:SIMPLE	Generator:Photovoltaic
GeometryTransform	GeometryTransform
GlycolConcentrations	FluidProperties:GlycolConcentrations
GROUND HEAT EXCHANGER:POND	GroundHeatExchanger:Pond
GROUND HEAT EXCHANGER:SURFACE	GroundHeatExchanger:Surface
GROUND HEAT EXCHANGER:VERTICAL	GroundHeatExchanger:Vertical
GroundReflectances	Site:GroundReflectance
GroundTemperatures	Site:GroundTemperature:BuildingSurface
GroundTemperatures:Deep	Site:GroundTemperature:Deep
GroundTemperatures:Surface	Site:GroundTemperature:Shallow
GROUNDWATER WELL	WaterUse:Well
HEADERED PUMPS:SIMPLE:CONSTANT SPEED	HeaderedPumps:ConstantSpeed
HEADERED PUMPS:SIMPLE:VARIABLE SPEED	HeaderedPumps:VariableSpeed
HEAT EXCHANGER:AIR TO AIR:FLAT PLATE	HeatExchanger:AirToAir:FlatPlate
HEAT EXCHANGER:AIR TO AIR:GENERIC	HeatExchanger:AirToAir:SensibleAndLatent
HEAT EXCHANGER:DESICCANT:BALANCEDFLOW	HeatExchanger:Desiccant:BalancedFlow
HEAT EXCHANGER:DESICCANT:BALANCEDFLOW:PERFORMANCE DATA TYPE 1	HeatExchanger:Desiccant:BalancedFlow:PerformanceDataType1
HEAT EXCHANGER:HYDRONIC:FREE COOLING	HeatExchanger:Hydronic
HEAT EXCHANGER:PLATE:FREE COOLING	HeatExchanger:Plate
HEAT EXCHANGER:WATERSIDE ECONOMIZER	HeatExchanger:WatersideEconomizer
HEAT PUMP:WATER HEATER	WaterHeater:HeatPump
HEATING LOAD RANGE BASED OPERATION	PlantEquipmentOperation:HeatingLoad
HeatPump:WaterToWater:EquationFit:Cooling	HeatPump:WaterToWater:EquationFit:Cooling
HeatPump:WaterToWater:EquationFit:Heating	HeatPump:WaterToWater:EquationFit:Heating
HeatPump:WaterToWater:ParameterEstimation:Cooling	HeatPump:WaterToWater:ParameterEstimation:Cooling
HeatPump:WaterToWater:ParameterEstimation:Heating	HeatPump:WaterToWater:ParameterEstimation:Heating
HIGH TEMP RADIANT SYSTEM	ZoneHVAC:HighTemperatureRadiant
HOT WATER EQUIPMENT	HotWaterEquipment
HUMIDIFIER:STEAM:ELECTRICAL	Humidifier:Steam:Electric
INFILTRATION	ZoneInfiltration
INSIDE CONVECTION ALGORITHM	SurfaceConvectionAlgorithm:Inside
Light Well	DaylightingDevice:LightWell
LIGHTS	Lights
List:Refrigeration:Cases	Refrigeration:CaseList
List:Refrigeration:Compressors	Refrigeration:CompressorList
Location	Site:Location
LOW TEMP RADIANT SYSTEM:CONSTANT FLOW	ZoneHVAC:LowTemperatureRadiant:ConstantFlow
LOW TEMP RADIANT SYSTEM:ELECTRIC	ZoneHVAC:LowTemperatureRadiant:Electric
LOW TEMP RADIANT SYSTEM:HYDRONIC	ZoneHVAC:LowTemperatureRadiant:VariableFlow
MATERIAL:AIR	Material:AirGap
MATERIAL:ECOROOF	Material:RoofVegetation
MATERIAL:IRT	Material:InfraredTransparent
MATERIAL:REGULAR	Material
MATERIAL:REGULAR-R	Material:NoMass
MATERIAL:WINDOWBLIND	WindowMaterial:Blind
MATERIAL:WINDOWGAS	WindowMaterial:Gas
MATERIAL:WINDOWGASMIXTURE	WindowMaterial:GasMixture
MATERIAL:WINDOWGLASS	WindowMaterial:Glazing
MATERIAL:WINDOWGLASS:AltInput	WindowMaterial:Glazing:RefractionExtinctionMethod
MATERIAL:WINDOWSCREEN	WindowMaterial:Screen
MATERIAL:WINDOWSHADE	WindowMaterial:Shade
MATERIALPROPERTY:MOISTURE:EMPD	MaterialProperty:MoisturePenetrationDepth:Settings
MATERIALPROPERTY:MOISTURE:HAMT-ISOTHERM	MaterialProperty:HeatAndMoistureTransfer:SorptionIsotherm
MATERIALPROPERTY:MOISTURE:HAMT-MU	MaterialProperty:HeatAndMoistureTransfer:Diffusion
MATERIALPROPERTY:MOISTURE:HAMT-PROPERTIES	MaterialProperty:HeatAndMoistureTransfer:Settings
MATERIALPROPERTY:MOISTURE:HAMT-REDISTRIBUTION	MaterialProperty:HeatAndMoistureTransfer:Redistribution
MATERIALPROPERTY:MOISTURE:HAMT-SUCTION	MaterialProperty:HeatAndMoistureTransfer:Suction
MATERIALPROPERTY:MOISTURE:HAMT-THERMAL	MaterialProperty:HeatAndMoistureTransfer:ThermalConductivity
MATERIALPROPERTY:TEMPERATUREDEP:CondFD	MaterialProperty:PhaseChange
MIXER	Connector:Mixer
MIXING	ZoneMixing
MovableInsulation	SurfaceControl:MovableInsulation
MUNDT MODEL CONTROLS	RoomAirSettings:OneNodeDisplacementVentilation
NODE LIST	NodeList
OTHER EQUIPMENT	OtherEquipment
OtherSideCoefficients	SurfaceProperty:OtherSideCoefficients
OtherSideConditionsModel	SurfaceProperty:OtherSideConditionsModel
OUTDOOR DEWPOINT RANGE BASED OPERATION	PlantEquipmentOperation:OutdoorDewpoint
OUTDOOR DEWPOINT TEMPERATURE DIFFERENCE BASED OPERATION	PlantEquipmentOperation:OutdoorDewpointDifference
OUTDOOR DRYBULB RANGE BASED OPERATION	PlantEquipmentOperation:OutdoorDryBulb
OUTDOOR DRYBULB TEMPERATURE DIFFERENCE BASED OPERATION	PlantEquipmentOperation:OutdoorDryBulbDifference
OUTDOOR RHPERCENT RANGE BASED OPERATION	PlantEquipmentOperation:OutdoorRelativeHumidity
OUTDOOR WETBULB RANGE BASED OPERATION	PlantEquipmentOperation:OutdoorWetBulb
OUTDOOR WETBULB TEMPERATURE DIFFERENCE BASED OPERATION	PlantEquipmentOperation:OutdoorWetBulbDifference
Output:SQLite	Output:SQLite
OUTSIDE AIR INLET NODE LIST	OutdoorAir:NodeList
OUTSIDE AIR MIXER	OutdoorAir:Mixer
OUTSIDE AIR NODE	OutdoorAir:Node
OUTSIDE AIR SYSTEM	AirLoopHVAC:OutdoorAirSystem
OUTSIDE CONVECTION ALGORITHM	SurfaceConvectionAlgorithm:Outside
PACKAGEDTERMINAL:AIRCONDITIONER	ZoneHVAC:PackagedTerminalAirConditioner
PACKAGEDTERMINAL:HEATPUMP:AIRTOAIR	ZoneHVAC:PackagedTerminalHeatPump
PEOPLE	People
PhotovoltaicPerformance:EquivalentOne-Diode	PhotovoltaicPerformance:EquivalentOne-Diode
PhotovoltaicPerformance:Sandia	PhotovoltaicPerformance:Sandia
PhotovoltaicPerformance:Simple	PhotovoltaicPerformance:Simple
PIPE	Pipe:Adiabatic
PIPE:EXTERIOR	Pipe:Outdoor
PIPE:INTERIOR	Pipe:Indoor
PIPE:STEAM	Pipe:Adiabatic:Steam
PIPE:UNDERGROUND	Pipe:Underground
PLANT EQUIPMENT LIST	PlantEquipmentList
PLANT LOAD PROFILE	LoadProfile:Plant
PLANT LOOP	PlantLoop
PLANT OPERATION SCHEMES	PlantEquipmentOperationSchemes
PLANT SIZING	Sizing:Plant
Preprocessor Message	Output:PreprocessorMessage
PUMP:CONDENSATE	Pump:VariableSpeed:Condensate
PUMP:CONSTANT SPEED	Pump:ConstantSpeed
PUMP:VARIABLE SPEED	Pump:VariableSpeed
PURCHASED AIR	ZoneHVAC:IdealLoadsAirSystem
PURCHASED:CHILLED WATER	DistrictCooling
PURCHASED:HOT WATER	DistrictHeating
PV MODULE:SANDIA PARAMETERS	PhotovoltaicPerformance:Sandia
RADIANT SYSTEM SURFACE GROUP	ZoneHVAC:LowTemperatureRadiant:SurfaceGroup
RAINWATER COLLECTOR	WaterUse:RainCollector
Refrigeration:Compressor	Refrigeration:Compressor
Refrigeration:Condenser:AirCooled	Refrigeration:Condenser:AirCooled
Refrigeration:Condenser:EvaporativeCooled	Refrigeration:Condenser:EvaporativeCooled
Refrigeration:Condenser:WaterCooled	Refrigeration:Condenser:WaterCooled
Refrigeration:Subcooler	Refrigeration:Subcooler
Refrigeration:System	Refrigeration:System
Report	Output:Reports
Report Cumulative Meter	Output:Meter:Cumulative
Report Cumulative MeterFileOnly	Output:Meter:Cumulative:MeterFileOnly
Report Environmental Impact Factors	Output:EnvironmentalImpactFactors
Report Meter	Output:Meter
Report MeterFileOnly	Output:Meter:MeterFileOnly
Report Variable	Output:Variable
Report:SurfaceColorScheme	OutputControl:SurfaceColorScheme
Report:Table:Monthly	Output:Table:Monthly
Report:Table:Predefined	Output:Table:SummaryReports
Report:Table:Style	OutputControl:Table:Style
Report:Table:TimeBins	Output:Table:TimeBins
ROOF IRRIGATION	RoofIrrigation
ROOMAIR MODEL	RoomAirModelType
ROOMAIR NODE	RoomAir:Node
ROOMAIR TEMPERATURE PATTERN:CONSTANT GRADIENT	RoomAir:TemperaturePattern:ConstantGradient
ROOMAIR TEMPERATURE PATTERN:NON-DIMENSIONAL HEIGHT	RoomAir:TemperaturePattern:NondimensionalHeight
ROOMAIR TEMPERATURE PATTERN:SURFACE MAPPING	RoomAir:TemperaturePattern:SurfaceMapping
ROOMAIR TEMPERATURE PATTERN:TWO GRADIENT INTERPOLATION	RoomAir:TemperaturePattern:TwoGradient
RUN CONTROL	SimulationControl
RunPeriod	RunPeriod
RunPeriod:Design	SizingPeriod:WeatherFileDays
RunPeriod:DesignSelectionFromWeatherFile	SizingPeriod:WeatherFileConditionType
SCHEDULE	Schedule:Year
SCHEDULE:COMPACT	Schedule:Compact
SCHEDULE:FILE:COMMA	Schedule:File
ScheduleType	ScheduleTypeLimits
SET POINT MANAGER:COLDEST	SetpointManager:Coldest
SET POINT MANAGER:MIXED AIR	SetpointManager:MixedAir
SET POINT MANAGER:OUTSIDE AIR	SetpointManager:OutdoorAirReset
SET POINT MANAGER:OUTSIDE AIR PRETREAT	SetpointManager:OutdoorAirPretreat
SET POINT MANAGER:RETURN AIR BYPASS FLOW	SetpointManager:ReturnAirBypassFlow
SET POINT MANAGER:SCHEDULED	SetpointManager:Scheduled
SET POINT MANAGER:SCHEDULED:DUALSETPOINT	SetpointManager:Scheduled:DualSetpoint
SET POINT MANAGER:SINGLE ZONE COOLING	SetpointManager:SingleZone:Cooling
SET POINT MANAGER:SINGLE ZONE HEATING	SetpointManager:SingleZone:Heating
SET POINT MANAGER:SINGLE ZONE MAX HUM	SetpointManager:SingleZone:Humidity:Maximum
SET POINT MANAGER:SINGLE ZONE MIN HUM	SetpointManager:SingleZone:Humidity:Minimum
SET POINT MANAGER:SINGLE ZONE REHEAT	SetpointManager:SingleZone:Reheat
SET POINT MANAGER:WARMEST	SetpointManager:Warmest
SET POINT MANAGER:WARMEST TEMP FLOW	SetpointManager:WarmestTemperatureFlow
Shading Surface Reflectance	ShadingProperty:Reflectance
SHADOWING CALCULATIONS	ShadowCalculation
SINGLE COOLING SETPOINT	ThermostatSetpoint:SingleCooling
SINGLE DUCT:CONST VOLUME:4 PIPE INDUC	AirTerminal:SingleDuct:ConstantVolume:FourPipeInduction
SINGLE DUCT:CONST VOLUME:REHEAT	AirTerminal:SingleDuct:ConstantVolume:Reheat
SINGLE DUCT:PARALLEL PIU:REHEAT	AirTerminal:SingleDuct:ParallelPIU:Reheat
SINGLE DUCT:SERIES PIU:REHEAT	AirTerminal:SingleDuct:SeriesPIU:Reheat
SINGLE DUCT:VAV:NOREHEAT	AirTerminal:SingleDuct:VAV:NoReheat
SINGLE DUCT:VAV:REHEAT	AirTerminal:SingleDuct:VAV:Reheat
SINGLE DUCT:VAV:REHEAT:VS FAN	AirTerminal:SingleDuct:VAV:Reheat:VariableSpeedFan
SINGLE DUCT:VAVHEATANDCOOL:NOREHEAT	AirTerminal:SingleDuct:VAV:HeatAndCool:NoReheat
SINGLE DUCT:VAVHEATANDCOOL:REHEAT	AirTerminal:SingleDuct:VAV:HeatAndCool:Reheat
SINGLE HEATING COOLING SETPOINT	ThermostatSetpoint:SingleHeatingOrCooling
SINGLE HEATING SETPOINT	ThermostatSetpoint:SingleHeating
SINGLE THERMAL COMFORT COOLING SETPOINT:FANGER	ThermostatSetpoint:ThermalComfort:Fanger:SingleCooling
SINGLE THERMAL COMFORT HEATING COOLING SETPOINT:FANGER	ThermostatSetpoint:ThermalComfort:Fanger:SingleHeatingOrCooling
SINGLE THERMAL COMFORT HEATING SETPOINT:FANGER	ThermostatSetpoint:ThermalComfort:Fanger:SingleHeating
SITE ATMOSPHERIC VARIATION	Site:HeightVariation
SITE PRECIPITATION	Site:Precipitation
SIZING PARAMETERS	Sizing:Parameters
Sizing:Output:Style	OutputControl:Sizing:Style
Snow Ground Reflectance Modifiers	Site:GroundReflectance:SnowModifier
SOLAR COLLECTOR PARAMETERS:FLAT PLATE	SolarCollectorPerformance:FlatPlate
SOLAR COLLECTOR:FLAT PLATE	SolarCollector:FlatPlate:Water
SOLAR COLLECTOR:UNGLAZED TRANSPIRED	SolarCollector:UnglazedTranspired
SOLAR COLLECTOR:UNGLAZED TRANSPIRED:MULTISYSTEM	SolarCollector:UnglazedTranspired:Multisystem
SolarCollector:FlatPlate:PhotovoltaicThermal	SolarCollector:FlatPlate:PhotovoltaicThermal
SolarCollectorPerformance:PhotovoltaicThermal:Simple	SolarCollectorPerformance:PhotovoltaicThermal:Simple
SOLUTION ALGORITHM	HeatBalanceAlgorithm
SpecialDayPeriod	RunPeriodControl:SpecialDays
SPLITTER	Connector:Splitter
STEAM EQUIPMENT	SteamEquipment
StormWindow	WindowProperty:StormWindow
Surface:HeatTransfer	BuildingSurface:Detailed
Surface:HeatTransfer:ExteriorNaturalVentedCavity	SurfaceProperty:ExteriorNaturalVentedCavity
Surface:HeatTransfer:InternalMass	InternalMass
Surface:HeatTransfer:Sub	FenestrationSurface:Detailed
Surface:Shading:Attached	Shading:Zone:Detailed
Surface:Shading:Detached:Building	Shading:Building:Detailed
Surface:Shading:Detached:Fixed	Shading:Site:Detailed
SurfaceGeometry	GlobalGeometryRules
SYSTEM AVAILABILITY MANAGER LIST	AvailabilityManagerAssignmentList
SYSTEM AVAILABILITY MANAGER:DIFFERENTIAL THERMOSTAT	AvailabilityManager:DifferentialThermostat
SYSTEM AVAILABILITY MANAGER:HIGH TEMPERATURE TURN OFF	AvailabilityManager:HighTemperatureTurnOff
SYSTEM AVAILABILITY MANAGER:HIGH TEMPERATURE TURN ON	AvailabilityManager:HighTemperatureTurnOn
SYSTEM AVAILABILITY MANAGER:HYBRID VENTILATION CONTROL	AvailabilityManager:HybridVentilation
SYSTEM AVAILABILITY MANAGER:LOW TEMPERATURE TURN OFF	AvailabilityManager:LowTemperatureTurnOff
SYSTEM AVAILABILITY MANAGER:LOW TEMPERATURE TURN ON	AvailabilityManager:LowTemperatureTurnOn
SYSTEM AVAILABILITY MANAGER:NIGHT CYCLE	AvailabilityManager:NightCycle
SYSTEM AVAILABILITY MANAGER:NIGHT VENTILATION	AvailabilityManager:NightVentilation
SYSTEM AVAILABILITY MANAGER:SCHEDULED	AvailabilityManager:Scheduled
SYSTEM AVAILABILITY MANAGER:SCHEDULED OFF	AvailabilityManager:ScheduledOff
SYSTEM AVAILABILITY MANAGER:SCHEDULED ON	AvailabilityManager:ScheduledOn
System Convergence Limits	ConvergenceLimits
SYSTEM SIZING	Sizing:System
THERMAL STORAGE:ICE:DETAILED	ThermalStorage:Ice:Detailed
THERMAL STORAGE:ICE:SIMPLE	ThermalStorage:Ice:Simple
THERMALCHIMNEY	ZoneThermalChimney
ThermalStorage:ChilledWater:Mixed	ThermalStorage:ChilledWater:Mixed
ThermalStorage:ChilledWater:Stratified	ThermalStorage:ChilledWater:Stratified
TIMESTEP IN HOUR	Timestep
UCSD CROSS VENTILATION MODEL CONTROLS	RoomAirSettings:CrossVentilation
UCSD DISPLACEMENT VENTILATION MODEL CONTROLS	RoomAirSettings:ThreeNodeDisplacementVentilation
UCSD UFAD EXTERIOR MODEL CONTROLS	RoomAirSettings:UnderFloorAirDistributionExterior
UCSD UFAD INTERIOR MODEL CONTROLS	RoomAirSettings:UnderFloorAirDistributionInterior
UNCONTROLLED LOOP OPERATION	PlantEquipmentOperation:Uncontrolled
UNIT HEATER	ZoneHVAC:UnitHeater
UNIT VENTILATOR	ZoneHVAC:UnitVentilator
UNITARYSYSTEM:HEATCOOL	AirLoopHVAC:UnitaryHeatCool
UNITARYSYSTEM:HEATONLY	AirLoopHVAC:UnitaryHeatOnly
UNITARYSYSTEM:HEATPUMP:AIRTOAIR	AirLoopHVAC:UnitaryHeatPump:AirToAir
UnitarySystem:HeatPump:WaterToAir	AirLoopHVAC:UnitaryHeatPump:WaterToAir
UNITARYSYSTEM:MULTISPEEDHEATPUMP:AIRTOAIR	AirLoopHVAC:UnitaryHeatPump:AirToAir:MultiSpeed
UNITARYSYSTEM:VAV:CHANGEOVERBYPASS	AirLoopHVAC:UnitaryHeatCool:VAVChangeoverBypass
USER DEFINED ROOMAIR TEMPERATURES	RoomAir:TemperaturePattern:UserDefined
UserViewFactors	ZoneProperty:UserViewFactors
VALVE:TEMPERING	TemperingValve
VaporCoefficients	SurfaceProperties:VaporCoefficients
VENTILATED SLAB	ZoneHVAC:VentilatedSlab
VENTILATION	ZoneVentilation
VENTILATION:MECHANICAL	Controller:MechanicalVentilation
VERSION	Version
WATER HEATER:MIXED	WaterHeater:Mixed
WATER HEATER:SIZING	WaterHeater:Sizing
WATER HEATER:STRATIFIED	WaterHeater:Stratified
WATER MAINS TEMPERATURES	Site:WaterMainsTemperature
WATER STORAGE TANK	WaterUse:Storage
WATER USE CONNECTIONS	WaterUse:Connections
WATER USE EQUIPMENT	WaterUse:Equipment
WEATHER STATION	Site:WeatherStation
WEEKSCHEDULE	Schedule:Week:Daily
WEEKSCHEDULE:COMPACT	Schedule:Week:Compact
WindowFrameAndDivider	WindowProperty:FrameAndDivider
WindowGapAirflowControl	WindowProperty:AirflowControl
WindowGlassSpectralData	MaterialProperty:GlazingSpectralData
WindowShadingControl	WindowProperty:ShadingControl
ZONE	Zone
ZONE CONTROL:HUMIDISTAT	ZoneControl:Humidistat
ZONE CONTROL:THERMAL COMFORT	ZoneControl:Thermostat:ThermalComfort
ZONE CONTROL:THERMOSTATIC	ZoneControl:Thermostat
ZONE CONTROL:THERMOSTATIC:OPERATIVE TEMPERATURE	ZoneControl:Thermostat:OperativeTemperature
ZONE EQUIPMENT LIST	ZoneHVAC:EquipmentList
ZONE EXHAUST FAN	Fan:ZoneExhaust
ZONE GROUP	ZoneGroup
ZONE LIST	ZoneList
ZONE MIXER	AirLoopHVAC:ZoneMixer
ZONE RETURN AIR PATH	AirLoopHVAC:ReturnPath
ZONE RETURN PLENUM	AirLoopHVAC:ReturnPlenum
ZONE SIZING	Sizing:Zone
ZONE SPLITTER	AirLoopHVAC:ZoneSplitter
ZONE SUPPLY AIR PATH	AirLoopHVAC:SupplyPath
ZONE SUPPLY PLENUM	AirLoopHVAC:SupplyPlenum
ZONE VOLUME CAPACITANCE MULTIPLIER	ZoneCapacitanceMultiplier
